Data Month,metdiv23,Net New Enrollments Alternative Verification Process,Net New Enrollments Verified by School,Net New Enrollments Lifeline,Net New Enrollments National Verifier Application,Net New Enrollments Total,Total Alternative Verification Process,Total Verified by School,Total Lifeline,Total National Verifier Application,Total Subscribers
2022-01-01,11244,1301,2,814,2203,4320,18438,9,32219,18300,68966
2022-02-01,11244,2261,0,1498,379,4138,20699,9,33717,18679,73104
2022-03-01,11244,2584,0,2781,1997,7362,23283,9,36498,20676,80466
2022-04-01,11244,2668,0,2031,2378,7077,25951,9,38529,23054,87543
2022-05-01,11244,3247,0,1191,3556,7994,29198,9,39720,26610,95537
2022-06-01,11244,3704,0,-2071,2838,4471,32902,9,37648,29448,100007
2022-07-01,11244,4180,-4,-1568,2122,4730,37082,5,36080,31570,104737
2022-08-01,11244,3805,0,-4642,3004,2167,40887,5,31438,34574,106904
2022-09-01,11244,3305,0,1072,2633,7010,44192,5,32510,37207,113914
2022-10-01,11244,2723,0,646,2546,5915,46915,5,33156,39753,119829
2022-11-01,11244,2438,0,-1966,1842,2314,49353,5,31190,41595,122143
2022-12-01,11244,2631,0,-1232,1863,3262,51984,5,29958,43458,125405
2023-01-01,11244,488,0,2434,2821,5743,52472,5,32392,46279,131148
2023-02-01,11244,2772,0,482,3394,6648,55244,5,32874,49673,137796
2023-03-01,11244,2584,0,607,6508,9699,57828,5,33481,56181,147495
2023-04-01,11244,2592,0,-216,6253,8629,60420,5,33265,62434,156124
2023-05-01,11244,2765,0,449,324,3538,63185,5,33714,62758,159662
2023-06-01,11244,3180,0,-642,5288,7826,66365,5,33072,68046,167488
2023-07-01,11244,1892,0,54,4859,6805,68257,5,33126,72905,174293
2023-08-01,11244,2318,0,400,5319,8037,70575,5,33526,78224,182330
2023-09-23,11244,2157,0,599,4399,7155,72732,5,34125,82623,189485
2023-10-01,11244,1387,-3,939,4551,6874,74119,2,35064,87174,196359
2023-11-01,11244,384,0,-114,3734,4004,74503,2,34950,90908,200363
2023-12-01,11244,45,0,-1953,4040,2132,74548,2,32997,94948,202495
2022-01-01,11694,516,2,612,1179,2309,4816,11,9730,8967,23524
2022-02-01,11694,539,0,364,659,1562,5355,11,10094,9626,25086
2022-03-01,11694,338,0,888,1336,2562,5693,11,10982,10962,27648
2022-04-01,11694,215,0,305,1301,1821,5908,11,11290,12263,29472
2022-05-01,11694,279,0,97,964,1340,6187,11,11387,13227,30812
2022-06-01,11694,289,0,146,1430,1865,6476,11,11533,14657,32677
2022-07-01,11694,252,-4,321,1419,1988,6728,7,11854,16076,34665
2022-08-01,11694,317,-1,-345,1445,1416,7045,6,11509,17521,36081
2022-09-01,11694,293,0,673,1317,2283,7338,6,12182,18838,38364
2022-10-01,11694,344,0,349,1526,2219,7682,6,12531,20364,40583
2022-11-01,11694,154,0,339,1490,1983,7836,6,12870,21854,42566
2022-12-01,11694,-786,-1,299,2491,2003,7050,5,13169,24345,44569
2023-01-01,11694,-128,0,824,1753,2449,6922,5,13993,26098,47018
2023-02-01,11694,310,0,317,2414,3041,7232,5,14310,28512,50059
2023-03-01,11694,297,0,-85,3048,3260,7529,5,14225,31560,53319
2023-04-01,11694,202,0,-15,3093,3280,7731,5,14210,34653,56599
2023-05-01,11694,576,0,35,3140,3751,8307,5,14245,37793,60350
2023-06-01,11694,490,0,292,1721,2503,8797,5,14537,39514,62853
2023-07-01,11694,482,0,264,1752,2498,9279,5,14801,41266,65351
2023-08-01,11694,456,0,288,2341,3085,9735,5,15089,43606,68435
2023-09-23,11694,443,0,238,1578,2259,10178,5,15327,45184,70694
2023-10-01,11694,-1,-1,-190,1272,1080,10177,4,15138,46456,71775
2023-11-01,11694,360,0,-815,2175,1720,10537,4,14323,48631,73495
2023-12-01,11694,338,0,-463,5301,5176,10875,4,13860,53932,78671
2022-01-01,12054,2173,-1,5450,3298,10920,20218,17,94291,32203,146729
2022-02-01,12054,1258,0,7030,2532,10820,21476,17,101321,34735,157549
2022-03-01,12054,1072,0,9518,4519,15109,22548,17,110839,39254,172658
2022-04-01,12054,25,0,2213,5052,7290,22573,17,113053,44306,179949
2022-05-01,12054,419,0,3296,6767,10482,22992,17,116349,51073,190431
2022-06-01,12054,327,-1,-1242,6780,5864,23319,16,115107,57853,196295
2022-07-01,12054,571,-6,-2747,6060,3878,23890,10,112360,63913,200173
2022-08-01,12054,302,0,-2172,5214,3344,24192,10,110188,69127,203517
2022-09-01,12054,598,0,806,5050,6454,24790,10,110994,74177,209971
2022-10-01,12054,356,-1,1388,4865,6608,25146,9,112382,79042,216579
2022-11-01,12054,216,0,-891,4253,3578,25362,9,111491,83295,220157
2022-12-01,12054,-3406,0,-3509,7593,678,21956,9,107982,90888,220835
2023-01-01,12054,359,-1,1664,5159,7181,22315,8,109646,96047,228016
2023-02-01,12054,853,0,432,5154,6439,23168,8,110078,101201,234455
2023-03-01,12054,786,-1,-1907,8343,7221,23954,7,108171,109544,241676
2023-04-01,12054,733,0,-2360,8472,6845,24687,7,105811,118016,248521
2023-05-01,12054,838,0,-2016,7145,5967,25525,7,103794,125161,254487
2023-06-01,12054,993,1,-2205,7823,6612,26518,8,101603,132994,261123
2023-07-01,12054,706,0,-1786,8035,6955,27224,8,99804,141022,268058
2023-08-01,12054,709,0,-1868,9271,8112,27933,8,97936,150293,276170
2023-09-23,12054,-387,-1,-3169,-403,-3960,27546,7,94767,149890,272210
2023-10-01,12054,344,-1,-1630,6081,4794,27890,6,93153,155990,277039
2023-11-01,12054,153,0,-2772,9874,7255,28043,6,90366,165841,284256
2023-12-01,12054,36,0,-7067,11012,3981,28079,6,83299,176853,288237
2022-01-01,14454,839,1,1437,1685,3962,5695,17,18937,12720,37369
2022-02-01,14454,397,-1,1301,2036,3733,6092,16,20238,14756,41102
2022-03-01,14454,357,0,2068,3014,5439,6449,16,22306,17770,46541
2022-04-01,14454,-186,-1,1016,3206,4035,6263,15,23322,20976,50576
2022-05-01,14454,-146,-1,293,3500,3646,6117,14,23615,24476,54222
2022-06-01,14454,-158,-1,-611,3773,3003,5959,13,23004,28249,57225
2022-07-01,14454,-111,-6,-571,2670,1982,5848,7,22433,30919,59207
2022-08-01,14454,-141,0,-1485,2067,441,5707,7,20948,32986,59648
2022-09-01,14454,-54,0,16,2980,2942,5653,7,20964,35966,62590
2022-10-01,14454,-99,0,58,1867,1826,5554,7,21022,37833,64416
2022-11-01,14454,-118,0,-998,1882,766,5436,7,20024,39715,65182
2022-12-01,14454,-2294,0,-425,2833,114,3142,7,19599,42548,65296
2023-01-01,14454,-35,0,-68,2525,2422,3107,7,19531,45072,67717
2023-02-01,14454,-67,0,260,2366,2559,3040,7,19791,47439,70277
2023-03-01,14454,-39,0,-47,3175,3089,3001,7,19744,50614,73366
2023-04-01,14454,-76,0,-294,4260,3890,2925,7,19450,54874,77256
2023-05-01,14454,3,0,661,3953,4617,2928,7,20111,58827,81873
2023-06-01,14454,-13,0,1289,3244,4520,2915,7,21400,62072,86394
2023-07-01,14454,19,0,699,2783,3501,2934,7,22099,64852,89892
2023-08-01,14454,51,0,1306,3161,4518,2985,7,23405,68013,94410
2023-09-23,14454,-815,0,290,-300,-825,2170,7,23695,67713,93585
2023-10-01,14454,-33,0,454,3527,3948,2137,7,24150,71242,97536
2023-11-01,14454,26,0,-2228,3438,1236,2163,7,21921,74678,98769
2023-12-01,14454,24,-1,-2136,3414,1301,2187,6,19785,78092,100070
2022-01-01,15764,697,-1,1446,2162,4304,4554,13,13543,13160,31270
2022-02-01,15764,357,0,1185,2226,3768,4911,13,14728,15386,35038
2022-03-01,15764,269,0,1686,2311,4266,5180,13,16414,17697,39304
2022-04-01,15764,-130,0,939,1996,2805,5050,13,17353,19693,42109
2022-05-01,15764,-109,-1,81,2027,1998,4941,12,17434,21720,44107
2022-06-01,15764,-62,-1,35,2085,2057,4879,11,17469,23805,46164
2022-07-01,15764,-60,-5,-283,2074,1726,4819,6,17186,25879,47890
2022-08-01,15764,-92,0,-756,2023,1175,4727,6,16430,27902,49065
2022-09-01,15764,-49,-1,172,2002,2124,4678,5,16602,29904,51189
2022-10-01,15764,-43,0,-179,1925,1703,4635,5,16423,31829,52892
2022-11-01,15764,-87,0,-615,1626,924,4548,5,15808,33455,53816
2022-12-01,15764,-1707,0,44,2345,682,2841,5,15852,35800,54498
2023-01-01,15764,-25,0,99,2385,2459,2816,5,15951,38185,56957
2023-02-01,15764,-18,0,-300,1963,1645,2798,5,15651,40148,58602
2023-03-01,15764,-26,0,-385,2504,2093,2772,5,15266,42652,60695
2023-04-01,15764,-50,0,-98,3431,3283,2722,5,15168,46083,63978
2023-05-01,15764,6,0,737,3602,4345,2728,5,15905,49685,68323
2023-06-01,15764,-38,0,1213,3243,4418,2690,5,17118,52928,72741
2023-07-01,15764,8,0,491,2377,2876,2698,5,17609,55305,75617
2023-08-01,15764,15,0,789,3038,3842,2713,5,18398,58343,79459
2023-09-23,15764,-798,0,93,634,-71,1915,5,18491,58977,79388
2023-10-01,15764,-48,0,106,2685,2743,1867,5,18597,61662,82131
2023-11-01,15764,18,0,-1391,2797,1424,1885,5,17206,64459,83555
2023-12-01,15764,-18,0,-1307,2873,1548,1867,5,15899,67332,85103
2022-01-01,15804,589,1,1060,855,2505,3885,4,10681,8268,22838
2022-02-01,15804,151,-2,896,1067,2112,4036,2,11577,9335,24950
2022-03-01,15804,35,0,1208,1244,2487,4071,2,12785,10579,27437
2022-04-01,15804,-152,0,-5,811,654,3919,2,12780,11390,28091
2022-05-01,15804,-138,0,445,1038,1345,3781,2,13225,12428,29436
2022-06-01,15804,-118,0,419,772,1073,3663,2,13644,13200,30509
2022-07-01,15804,-120,-1,114,1047,1040,3543,1,13758,14247,31549
2022-08-01,15804,-170,0,-12,946,764,3373,1,13746,15193,32313
2022-09-01,15804,-122,0,314,1049,1241,3251,1,14060,16242,33554
2022-10-01,15804,-111,0,235,1187,1311,3140,1,14295,17429,34865
2022-11-01,15804,-135,0,-424,565,6,3005,1,13871,17994,34871
2022-12-01,15804,-1785,0,86,1510,-189,1220,1,13957,19504,34682
2023-01-01,15804,-39,-1,240,1415,1615,1181,0,14197,20919,36297
2023-02-01,15804,-48,0,164,2352,2468,1133,0,14361,23271,38765
2023-03-01,15804,-46,0,-157,2208,2005,1087,0,14204,25479,40770
2023-04-01,15804,-40,0,-6,2004,1958,1047,0,14198,27483,42728
2023-05-01,15804,-38,0,-241,2339,2060,1009,0,13957,29822,44788
2023-06-01,15804,-26,0,23,2544,2541,984,0,13982,32373,47339
2023-07-01,15804,-33,0,129,1508,1604,950,0,14109,33872,48931
2023-08-01,15804,-33,0,261,1472,1700,917,0,14370,35344,50631
2023-09-23,15804,-621,0,-249,478,-392,296,0,14121,35822,50239
2023-10-01,15804,-31,0,-170,1661,1460,266,0,13953,37500,51719
2023-11-01,15804,-4,0,-813,2344,1527,262,0,13138,39822,53222
2023-12-01,15804,-7,0,-492,3339,2840,255,0,12646,43161,56062
2022-01-01,16984,3432,-1,5165,5815,14411,23136,40,77811,69049,170036
2022-02-01,16984,1373,4,5691,3166,10234,24509,44,83502,72215,180270
2022-03-01,16984,373,-1,8494,6882,15748,24882,43,91995,79097,196017
2022-04-01,16984,-1094,-1,6503,5692,11100,23788,42,98499,84789,207118
2022-05-01,16984,-1048,-2,4828,4467,8245,22740,40,103327,89256,215363
2022-06-01,16984,-862,-2,3353,4796,7285,21878,38,106680,94052,222648
2022-07-01,16984,-893,-9,3544,7662,10304,20985,29,110224,101714,232952
2022-08-01,16984,-1366,-1,-852,9841,7622,19619,28,109372,111555,240574
2022-09-01,16984,-740,-2,-445,9939,8752,18879,26,108927,121494,249326
2022-10-01,16984,-648,-1,-2277,8706,5780,18231,25,106650,130200,255106
2022-11-01,16984,-698,-1,-1737,6910,4474,17533,24,104913,137110,259580
2022-12-01,16984,-9535,-1,-1910,8721,-2725,7998,23,103003,145831,256855
2023-01-01,16984,-151,0,108,8244,8201,7847,23,103111,154075,265056
2023-02-01,16984,-287,-1,-1381,10119,8450,7560,22,101730,164194,273506
2023-03-01,16984,-253,-1,-1743,11965,9968,7307,21,99987,176159,283474
2023-04-01,16984,-168,0,82,13098,13012,7139,21,100069,189257,296486
2023-05-01,16984,-231,0,2886,11722,14377,6908,21,102955,200979,310863
2023-06-01,16984,-186,0,4672,11528,16014,6729,21,107718,212779,327247
2023-07-01,16984,-131,0,3518,10046,13433,6591,21,111143,222534,340289
2023-08-01,16984,-146,0,5203,11273,16330,6445,21,116346,233807,356619
2023-09-23,16984,-3273,0,2208,3196,2131,3172,21,118554,237003,358750
2023-10-01,16984,-242,-2,1226,10010,10992,2931,19,119886,247327,370163
2023-11-01,16984,-32,-1,-7180,17060,9847,2898,18,112596,264057,379569
2023-12-01,16984,-40,0,-7560,16125,8525,2858,18,105036,280182,388094
2022-01-01,19124,3595,-1,-209,3180,6565,46618,45,26941,31850,105454
2022-02-01,19124,4730,1,1206,504,6441,51348,46,28147,32354,111895
2022-03-01,19124,6011,-1,2004,3633,11647,57359,45,30151,35987,123542
2022-04-01,19124,3245,-3,-1638,4293,5897,60604,42,28513,40280,129439
2022-05-01,19124,5724,-2,-855,3935,8802,66328,40,27658,44215,138241
2022-06-01,19124,4840,-2,-965,4474,8347,71168,38,26693,48689,146588
2022-07-01,19124,6030,-15,-1195,4331,9151,77198,23,25498,53020,155739
2022-08-01,19124,4414,-2,-1967,3481,5926,81612,21,23531,56501,161665
2022-09-01,19124,4558,-1,301,3250,8108,86170,20,23832,59751,169773
2022-10-01,19124,3209,-2,18,3287,6512,89379,18,23850,63038,176285
2022-11-01,19124,2546,0,-1974,1606,2178,91925,18,21876,64644,178463
2022-12-01,19124,3474,0,1066,2383,6923,95399,18,22942,67027,185386
2023-01-01,19124,1130,0,201,3465,4796,96529,18,23143,70492,190182
2023-02-01,19124,3603,-1,155,4600,8357,100132,17,23298,75092,198539
2023-03-01,19124,3560,0,78,6478,10116,103692,17,23376,81570,208655
2023-04-01,19124,3048,0,-2807,7608,7849,106740,17,20569,89178,216504
2023-05-01,19124,3141,0,667,5074,8882,109881,17,21236,94252,225386
2023-06-01,19124,4083,0,550,5815,10448,114384,17,21828,100656,236885
2023-07-01,19124,2348,0,157,5043,7548,116297,17,21948,105070,243332
2023-08-01,19124,2907,11,598,5558,9074,119204,28,22546,110628,252406
2023-09-23,19124,2851,0,-2616,7485,7720,122055,28,19930,118113,260126
2023-10-01,19124,1077,1,837,4814,6729,123614,29,20807,123645,268095
2023-11-01,19124,-465,0,-19,5893,5409,122665,29,20745,128767,272206
2023-12-01,19124,-697,-1,-1596,30,-2264,121968,28,19149,128797,269942
2022-01-01,19804,1540,1,1671,2642,5854,10639,3,70243,32924,113809
2022-02-01,19804,440,0,2731,3533,6704,11079,3,72974,36457,120513
2022-03-01,19804,138,0,5866,3090,9094,11217,3,78840,39547,129607
2022-04-01,19804,-606,0,1821,651,1866,10611,3,80661,40198,131473
2022-05-01,19804,-479,0,1518,1377,2416,10132,3,82179,41575,133889
2022-06-01,19804,-421,0,-1171,3389,1797,9711,3,81008,44964,135686
2022-07-01,19804,-382,0,1610,2761,3989,9329,3,82618,47725,139675
2022-08-01,19804,-608,-1,-1953,3578,1016,8721,2,80665,51303,140691
2022-09-01,19804,-343,0,3160,4552,7369,8378,2,83825,55855,148060
2022-10-01,19804,-329,0,2484,4757,6912,8049,2,86309,60612,154972
2022-11-01,19804,-293,0,1023,5805,6535,7756,2,87332,66417,161507
2022-12-01,19804,-3160,0,-2730,5209,-681,4596,2,84602,71626,160826
2023-01-01,19804,-44,0,2352,3953,6261,4552,2,86954,75579,167087
2023-02-01,19804,57,0,482,4202,4741,4609,2,87436,79781,171828
2023-03-01,19804,14,0,-128,6158,6044,4623,2,87308,85939,177872
2023-04-01,19804,3,0,908,6612,7523,4626,2,88216,92551,185395
2023-05-01,19804,-32,0,2464,5846,8278,4594,2,90680,98397,193673
2023-06-01,19804,24,1,1179,5666,6870,4618,3,91861,104063,200545
2023-07-01,19804,-42,0,2182,6827,8967,4576,3,94042,110890,209511
2023-08-01,19804,14,0,3915,8248,12177,4590,3,97957,119138,221688
2023-09-23,19804,-981,0,2231,8629,9879,3609,3,100188,127767,231567
2023-10-01,19804,-67,-1,778,12525,13235,3542,2,100967,140294,244805
2023-11-01,19804,4,0,-4739,8905,4170,3546,2,96227,149196,248971
2023-12-01,19804,-94,0,-4894,18759,13771,3452,2,91333,167955,262742
2022-01-01,20994,275,-1,273,599,1146,2049,3,4372,4961,11385
2022-02-01,20994,124,0,138,560,822,2173,3,4510,5521,12207
2022-03-01,20994,75,0,379,654,1108,2248,3,4889,6175,13315
2022-04-01,20994,-78,0,204,604,730,2170,3,5093,6779,14045
2022-05-01,20994,-46,0,40,492,486,2124,3,5133,7271,14531
2022-06-01,20994,-42,0,107,639,704,2082,3,5240,7910,15235
2022-07-01,20994,-28,-1,136,908,1015,2054,2,5376,8818,16250
2022-08-01,20994,-87,0,-22,821,712,1967,2,5354,9639,16962
2022-09-01,20994,-42,0,-41,918,835,1925,2,5313,10557,17797
2022-10-01,20994,-34,0,-67,719,618,1891,2,5246,11276,18415
2022-11-01,20994,-35,0,0,506,471,1856,2,5246,11782,18886
2022-12-01,20994,-870,0,68,690,-112,986,2,5314,12472,18774
2023-01-01,20994,-7,0,251,926,1170,979,2,5565,13398,19944
2023-02-01,20994,8,-1,36,717,760,987,1,5601,14116,20705
2023-03-01,20994,-1,0,-175,876,700,986,1,5426,14992,21405
2023-04-01,20994,8,0,-81,978,905,994,1,5345,15970,22310
2023-05-01,20994,-5,0,-37,895,853,989,1,5308,16865,23163
2023-06-01,20994,-4,0,96,962,1054,985,1,5404,17829,24219
2023-07-01,20994,-6,0,83,816,893,979,1,5487,18643,25110
2023-08-01,20994,5,0,186,829,1020,984,1,5673,19471,26129
2023-09-23,20994,-329,0,7,168,-154,655,1,5680,19639,25975
2023-10-01,20994,-22,0,-12,986,952,633,1,5668,20627,26929
2023-11-01,20994,-10,0,-228,988,750,623,1,5440,21613,27677
2023-12-01,20994,-20,0,-236,1150,894,603,1,5204,22763,28571
2022-01-01,21794,198,1,153,304,656,1875,11,6552,3825,12263
2022-02-01,21794,114,0,289,162,565,1989,11,6841,3987,12828
2022-03-01,21794,45,-1,392,407,843,2034,10,7233,4394,13671
2022-04-01,21794,-70,-1,-402,456,-17,1964,9,6831,4850,13654
2022-05-01,21794,-73,-1,64,691,681,1891,8,6895,5541,14335
2022-06-01,21794,-59,0,-86,642,497,1832,8,6809,6183,14832
2022-07-01,21794,-67,-1,-125,579,386,1765,7,6684,6762,15218
2022-08-01,21794,-95,0,-222,419,102,1670,7,6462,7181,15320
2022-09-01,21794,-65,0,-63,536,408,1605,7,6399,7717,15728
2022-10-01,21794,-47,0,29,603,585,1558,7,6428,8320,16313
2022-11-01,21794,-69,0,-2,840,769,1489,7,6426,9160,17082
2022-12-01,21794,-888,0,-30,642,-276,601,7,6396,9802,16806
2023-01-01,21794,-17,0,85,570,638,584,7,6481,10372,17444
2023-02-01,21794,-12,-1,88,469,544,572,6,6569,10841,17988
2023-03-01,21794,-25,0,70,784,829,547,6,6639,11625,18817
2023-04-01,21794,-20,0,100,744,824,527,6,6739,12369,19641
2023-05-01,21794,-10,-1,-131,799,657,517,5,6608,13168,20298
2023-06-01,21794,-14,0,-101,751,636,503,5,6507,13919,20934
2023-07-01,21794,-11,0,-82,577,484,492,5,6425,14496,21418
2023-08-01,21794,-25,0,-50,686,611,467,5,6375,15182,22029
2023-09-23,21794,-15,0,18,703,706,452,5,6393,15885,22735
2023-10-01,21794,-271,0,77,504,310,181,5,6470,16389,23045
2023-11-01,21794,-29,0,122,441,534,152,5,6592,16830,23579
2023-12-01,21794,1,0,-30,821,792,153,5,6562,17651,24371
2022-01-01,22744,593,0,969,2286,3848,4819,3,16305,18106,39233
2022-02-01,22744,216,1,590,1903,2710,5035,4,16895,20009,41943
2022-03-01,22744,53,-1,908,3780,4740,5088,3,17803,23789,46683
2022-04-01,22744,-225,0,205,3201,3181,4863,3,18008,26990,49864
2022-05-01,22744,-204,0,-444,2779,2131,4659,3,17564,29769,51995
2022-06-01,22744,-170,0,-1625,2567,772,4489,3,15939,32336,52767
2022-07-01,22744,-160,0,-512,2407,1735,4329,3,15427,34743,54502
2022-08-01,22744,-331,0,-1716,3928,1881,3998,3,13711,38671,56383
2022-09-01,22744,-167,0,245,2505,2583,3831,3,13956,41176,58966
2022-10-01,22744,-140,0,1090,3284,4234,3691,3,15046,44460,63200
2022-11-01,22744,-156,0,678,3062,3584,3535,3,15724,47522,66784
2022-12-01,22744,-177,0,1474,3275,4572,3358,3,17198,50797,71356
2023-01-01,22744,-215,0,-1121,-2090,-3426,3143,3,16077,48707,67930
2023-02-01,22744,-109,0,-137,1148,902,3034,3,15940,49855,68832
2023-03-01,22744,-1808,0,-820,1799,-829,1226,3,15120,51654,68003
2023-04-01,22744,-48,0,-269,2975,2658,1178,3,14851,54629,70661
2023-05-01,22744,-45,0,-31,3016,2940,1133,3,14820,57645,73601
2023-06-01,22744,-38,0,191,2878,3031,1095,3,15015,60528,76641
2023-07-01,22744,-42,0,582,2596,3136,1053,3,15593,63118,79767
2023-08-01,22744,-45,0,477,4528,4960,1008,3,16070,67646,84727
2023-09-23,22744,-36,0,29,3198,3191,972,3,16099,70844,87918
2023-10-01,22744,-66,-1,-503,3682,3112,906,2,15600,74531,91039
2023-11-01,22744,-30,0,-1210,4629,3389,876,2,14386,79154,94418
2023-12-01,22744,-21,0,-979,4701,3701,855,2,13407,83855,98119
2022-01-01,23104,2111,3,-265,1531,3380,23558,29,13687,16125,53399
2022-02-01,23104,2450,0,775,188,3413,26008,29,14462,16313,56812
2022-03-01,23104,3139,0,1261,2346,6746,29147,29,15723,18659,63558
2022-04-01,23104,1965,-1,-1072,2557,3449,31112,28,14651,21217,67008
2022-05-01,23104,2876,0,-459,2771,5188,33988,28,14192,23988,72196
2022-06-01,23104,2522,-2,-23,2876,5373,36510,26,14169,26864,77569
2022-07-01,23104,2908,-14,-556,2368,4706,39418,12,13613,29232,82275
2022-08-01,23104,2035,0,-709,1996,3322,41453,12,12904,31228,85597
2022-09-01,23104,2274,0,142,2111,4527,43727,12,13046,33339,90124
2022-10-01,23104,1568,0,-9,2318,3877,45295,12,13037,35657,94001
2022-11-01,23104,1349,0,-963,1267,1653,46644,12,12074,36924,95654
2022-12-01,23104,1903,0,598,1710,4211,48547,12,12672,38634,99865
2023-01-01,23104,445,0,61,2449,2955,48992,12,12733,41083,102820
2023-02-01,23104,1703,0,81,2430,4214,50695,12,12814,43513,107034
2023-03-01,23104,1756,0,37,3584,5377,52451,12,12851,47097,112411
2023-04-01,23104,1510,-1,-1573,6058,5994,53961,11,11278,53155,118405
2023-05-01,23104,1776,0,343,3133,5252,55737,11,11621,56288,123657
2023-06-01,23104,2153,0,139,3139,5431,57892,11,11761,59452,129116
2023-07-01,23104,1311,-1,85,2768,4163,59200,10,11845,62191,133246
2023-08-01,23104,1734,0,410,2601,4745,60934,10,12255,64792,137991
2023-09-23,23104,1399,0,-1240,3847,4006,62333,10,11015,68639,141997
2023-10-01,23104,471,-2,402,2835,3706,62807,8,11419,71560,145794
2023-11-01,23104,-240,0,-61,3118,2817,62564,8,11355,74587,148514
2023-12-01,23104,-225,0,-967,-477,-1669,62339,8,10388,74110,146845
2022-01-01,23224,394,0,121,606,1121,2699,8,7062,4797,14566
2022-02-01,23224,135,0,250,16,401,2834,8,7312,4813,14967
2022-03-01,23224,67,0,453,644,1164,2901,8,7765,5457,16131
2022-04-01,23224,-118,-2,-294,544,130,2783,6,7472,6001,16262
2022-05-01,23224,-76,0,153,727,804,2707,6,7625,6728,17066
2022-06-01,23224,-69,0,22,577,530,2638,6,7647,7304,17595
2022-07-01,23224,-72,-2,129,527,582,2566,4,7776,7831,18177
2022-08-01,23224,-136,0,-28,706,542,2430,4,7748,8537,18719
2022-09-01,23224,-87,-1,159,734,805,2343,3,7907,9271,19524
2022-10-01,23224,-83,-1,43,1038,997,2260,2,7950,10309,20521
2022-11-01,23224,-77,0,-5,588,506,2183,2,7945,10897,21027
2022-12-01,23224,-1252,0,25,1514,287,931,2,7970,12411,21314
2023-01-01,23224,-21,0,305,1159,1443,910,2,8275,13570,22757
2023-02-01,23224,-24,0,122,983,1081,886,2,8397,14553,23838
2023-03-01,23224,-31,0,-46,1202,1125,855,2,8351,15755,24963
2023-04-01,23224,-35,0,-78,976,863,820,2,8273,16731,25826
2023-05-01,23224,-24,0,-47,1366,1295,796,2,8226,18097,27121
2023-06-01,23224,-24,0,120,1187,1283,772,2,8346,19286,28406
2023-07-01,23224,-21,0,342,1159,1480,751,2,8688,20443,29884
2023-08-01,23224,-41,0,398,1200,1557,710,2,9086,21643,31441
2023-09-23,23224,-454,0,-32,688,202,256,2,9054,22331,31643
2023-10-01,23224,-32,0,-82,1105,991,224,2,8972,23440,32638
2023-11-01,23224,-1,0,-423,978,554,223,2,8549,24414,33188
2023-12-01,23224,-7,0,-297,903,599,216,2,8252,25317,33787
2022-01-01,29404,240,0,212,485,937,1526,2,3045,4369,8942
2022-02-01,29404,78,0,171,270,519,1604,2,3216,4639,9461
2022-03-01,29404,49,0,263,619,931,1653,2,3479,5258,10392
2022-04-01,29404,-58,0,171,486,599,1595,2,3650,5744,10991
2022-05-01,29404,-55,0,58,270,273,1540,2,3708,6014,11264
2022-06-01,29404,-51,0,202,358,509,1489,2,3910,6372,11773
2022-07-01,29404,-69,-1,309,540,779,1420,1,4219,6912,12552
2022-08-01,29404,-107,0,120,677,690,1313,1,4339,7589,13242
2022-09-01,29404,-60,0,13,938,891,1253,1,4352,8527,14133
2022-10-01,29404,-54,0,42,536,524,1199,1,4394,9063,14657
2022-11-01,29404,-54,0,62,415,423,1145,1,4456,9478,15080
2022-12-01,29404,-665,0,96,503,-66,480,1,4552,9981,15014
2023-01-01,29404,-8,0,22,681,695,472,1,4574,10662,15709
2023-02-01,29404,-9,0,-114,491,368,463,1,4460,11153,16077
2023-03-01,29404,-15,0,-185,630,430,448,1,4275,11783,16507
2023-04-01,29404,-22,0,-88,624,514,426,1,4187,12407,17021
2023-05-01,29404,-24,0,71,758,805,402,1,4258,13165,17826
2023-06-01,29404,-12,0,236,743,967,390,1,4494,13908,18793
2023-07-01,29404,-19,0,434,584,999,371,1,4928,14492,19792
2023-08-01,29404,-7,0,287,528,808,364,1,5215,15020,20600
2023-09-23,29404,-229,0,93,83,-53,135,1,5308,15103,20547
2023-10-01,29404,-12,0,67,602,657,123,1,5375,15705,21204
2023-11-01,29404,1,0,-46,611,566,124,1,5329,16316,21770
2023-12-01,29404,-7,0,-109,760,644,117,1,5220,17076,22414
2022-01-01,29414,356,1,178,578,1113,2820,5,11658,6081,20564
2022-02-01,29414,154,0,450,465,1069,2974,5,12108,6546,21633
2022-03-01,29414,45,0,769,663,1477,3019,5,12877,7209,23110
2022-04-01,29414,-162,0,-493,749,94,2857,5,12384,7958,23204
2022-05-01,29414,-145,0,163,833,851,2712,5,12547,8791,24055
2022-06-01,29414,-140,0,380,746,986,2572,5,12927,9537,25041
2022-07-01,29414,-138,-1,26,1015,902,2434,4,12953,10552,25943
2022-08-01,29414,-230,0,374,442,586,2204,4,13327,10994,26529
2022-09-01,29414,-95,0,255,1002,1162,2109,4,13582,11996,27691
2022-10-01,29414,-89,-1,234,979,1123,2020,3,13816,12975,28814
2022-11-01,29414,-96,1,-34,806,677,1924,4,13782,13781,29491
2022-12-01,29414,-1108,3,-233,1324,-14,816,7,13549,15105,29477
2023-01-01,29414,-50,1,478,1211,1640,766,8,14027,16316,31117
2023-02-01,29414,-36,-1,15,1034,1012,730,7,14042,17350,32129
2023-03-01,29414,-28,0,-205,1392,1159,702,7,13837,18742,33288
2023-04-01,29414,-30,0,-63,1524,1431,672,7,13774,20266,34719
2023-05-01,29414,-36,0,29,1668,1661,636,7,13803,21934,36380
2023-06-01,29414,-29,1,258,1297,1527,607,8,14061,23233,37909
2023-07-01,29414,-28,0,253,1082,1307,579,8,14313,24311,39211
2023-08-01,29414,-30,0,54,1651,1675,549,8,14367,25962,40886
2023-09-23,29414,-368,0,-166,930,396,181,8,14201,26892,41282
2023-10-01,29414,-24,0,-210,1371,1137,157,8,13992,28266,42423
2023-11-01,29414,-5,0,-626,1455,824,152,8,13365,29719,43244
2023-12-01,29414,0,0,-529,1668,1139,152,8,12836,31387,44383
2022-01-01,29484,174,0,795,1206,2175,1733,8,9914,8963,20618
2022-02-01,29484,77,0,1084,158,1319,1810,8,10998,9121,21937
2022-03-01,29484,-8,0,1060,1087,2139,1802,8,12058,10208,24076
2022-04-01,29484,-51,2,125,1082,1158,1751,10,12183,11290,25234
2022-05-01,29484,-37,2,378,1549,1892,1714,12,12561,12839,27126
2022-06-01,29484,-28,1,342,1123,1438,1686,13,12903,13962,28564
2022-07-01,29484,-46,1,144,778,877,1640,14,13047,14740,29441
2022-08-01,29484,-56,0,144,1187,1275,1584,14,13191,15927,30716
2022-09-01,29484,-48,0,413,1166,1531,1536,14,13604,17093,32247
2022-10-01,29484,-38,0,331,852,1145,1498,14,13935,17945,33392
2022-11-01,29484,-44,0,-962,792,-214,1454,14,12973,18737,33178
2022-12-01,29484,-598,1,437,1630,1470,856,15,13410,20367,34648
2023-01-01,29484,-19,0,294,1852,2127,837,15,13704,22219,36775
2023-02-01,29484,-20,-2,148,2073,2199,817,13,13852,24292,38974
2023-03-01,29484,-24,0,-12,2139,2103,793,13,13840,26431,41077
2023-04-01,29484,-11,0,-94,1911,1806,782,13,13746,28342,42883
2023-05-01,29484,-24,-1,126,2282,2383,758,12,13872,30624,45266
2023-06-01,29484,-20,-1,320,2142,2441,738,11,14192,32766,47707
2023-07-01,29484,-13,1,225,1938,2151,725,12,14417,34704,49858
2023-08-01,29484,-21,-1,207,2166,2351,704,11,14624,36870,52209
2023-09-23,29484,-248,0,-573,273,-548,456,11,14051,37143,51661
2023-10-01,29484,-25,1,-21,2109,2064,431,12,14030,39252,53725
2023-11-01,29484,-4,-2,-725,2955,2224,427,10,13305,42207,55949
2023-12-01,29484,-8,-1,-409,3999,3581,419,9,12896,46206,59530
2022-01-01,31084,7680,1,-254,19938,27365,90351,20,179569,114780,384720
2022-02-01,31084,11415,-2,2729,12242,26384,101766,18,182298,127022,411104
2022-03-01,31084,15244,-1,6807,21157,43207,117010,17,189104,148179,454310
2022-04-01,31084,13376,-2,5080,16342,34796,130386,15,194185,164521,489107
2022-05-01,31084,15588,0,3978,16281,35847,145974,15,198163,180802,524954
2022-06-01,31084,17055,-1,-11601,10481,15934,163029,14,186562,191283,540888
2022-07-01,31084,20837,-7,-11547,6029,15312,183866,7,175015,197312,556200
2022-08-01,31084,17831,0,-27540,10636,927,201697,7,147475,207948,557127
2022-09-01,31084,15949,1,2546,7352,25848,217646,8,150021,215300,582975
2022-10-01,31084,11225,0,1908,6634,19767,228871,8,151929,221934,602742
2022-11-01,31084,9196,-1,-9060,2921,3056,238067,7,142869,224855,605798
2022-12-01,31084,11428,0,-6277,3517,8668,249495,7,136592,228372,614466
2023-01-01,31084,4922,0,9061,10551,24534,254417,7,145653,238923,639000
2023-02-01,31084,11306,-1,1933,10027,23265,265723,6,147586,248950,662265
2023-03-01,31084,10680,0,3328,18072,32080,276403,6,150914,267022,694345
2023-04-01,31084,11171,0,-404,14404,25171,287574,6,150510,281426,719516
2023-05-01,31084,10065,-2,4515,1163,15741,297639,4,155025,282589,735257
2023-06-01,31084,12393,0,-1909,23263,33747,310032,4,153116,305854,769006
2023-07-01,31084,6194,0,117,21238,27549,316226,4,153232,327090,796552
2023-08-01,31084,8277,0,7047,29823,45147,324503,4,160279,356913,841699
2023-09-23,31084,5662,0,4079,21892,31633,330165,4,164358,378805,873332
2023-10-01,31084,2681,-1,2912,23304,28896,332846,3,167271,402112,902232
2023-11-01,31084,-1899,0,-4126,32699,26674,330947,3,163144,434805,928899
2023-12-01,31084,-2538,0,-11842,34908,20528,328409,3,151302,469713,949427
2022-01-01,31924,551,-1,366,820,1736,5356,6,16033,7873,29268
2022-02-01,31924,355,0,995,1135,2485,5711,6,17028,9008,31753
2022-03-01,31924,330,-1,1251,1245,2825,6041,5,18279,10253,34578
2022-04-01,31924,85,-1,-632,1347,799,6126,4,17647,11600,35377
2022-05-01,31924,195,0,286,1558,2039,6321,4,17933,13158,37416
2022-06-01,31924,108,0,689,1549,2346,6429,4,18622,14707,39762
2022-07-01,31924,154,-1,120,1369,1642,6583,3,18742,16076,41404
2022-08-01,31924,89,0,-281,1205,1013,6672,3,18461,17281,42417
2022-09-01,31924,179,0,422,1258,1859,6851,3,18883,18539,44276
2022-10-01,31924,82,0,560,1198,1840,6933,3,19443,19737,46116
2022-11-01,31924,17,0,340,722,1079,6950,3,19783,20459,47195
2022-12-01,31924,-861,0,-157,1611,593,6089,3,19626,22070,47788
2023-01-01,31924,29,0,204,1638,1871,6118,3,19830,23708,49659
2023-02-01,31924,276,0,-23,1293,1546,6394,3,19807,25001,51205
2023-03-01,31924,151,0,-202,1782,1731,6545,3,19605,26783,52936
2023-04-01,31924,158,0,-244,1648,1562,6703,3,19361,28431,54498
2023-05-01,31924,172,0,-446,1867,1593,6875,3,18915,30298,56091
2023-06-01,31924,229,0,-367,1873,1735,7104,3,18549,32177,57833
2023-07-01,31924,112,0,-308,1637,1441,7216,3,18240,33807,59266
2023-08-01,31924,156,0,-280,1943,1819,7372,3,17960,35750,61085
2023-09-23,31924,-190,0,-525,-470,-1185,7182,3,17435,35280,59900
2023-10-01,31924,25,-1,-172,1010,862,7207,2,17264,36297,60770
2023-11-01,31924,-34,0,-608,2204,1562,7173,2,16656,38494,62325
2023-12-01,31924,-18,0,-1232,2338,1088,7155,2,15424,40832,63413
2022-01-01,33124,859,0,2872,10178,13909,6537,4,45528,52796,104865
2022-02-01,33124,423,0,1311,9396,11130,6960,4,46839,62192,115995
2022-03-01,33124,260,0,2433,11040,13733,7220,4,49272,73232,129728
2022-04-01,33124,-377,0,781,9091,9495,6843,4,50053,82323,139223
2022-05-01,33124,-319,0,-572,5331,4440,6524,4,49481,87654,143663
2022-06-01,33124,-250,2,-6273,2405,-4116,6274,6,43208,90059,139547
2022-07-01,33124,-247,-1,-1894,2042,-100,6027,5,41314,92101,139447
2022-08-01,33124,-415,-1,-6249,4564,-2101,5612,4,35065,96665,137346
2022-09-01,33124,-208,0,357,2273,2422,5404,4,35422,98938,139768
2022-10-01,33124,-202,0,1245,8392,9435,5202,4,36667,107330,149203
2022-11-01,33124,-403,0,1854,6710,8161,4799,4,38521,114040,157364
2022-12-01,33124,-369,-2,3256,6932,9817,4430,2,41777,120972,167181
2023-01-01,33124,-242,0,-3352,-10814,-14408,4188,2,38425,110157,152772
2023-02-01,33124,-145,0,134,4312,4301,4043,2,38559,114469,157073
2023-03-01,33124,-2206,0,-629,5633,2798,1837,2,37930,120102,159871
2023-04-01,33124,-95,0,-499,6646,6052,1742,2,37431,126748,165923
2023-05-01,33124,-81,0,2028,5850,7797,1661,2,39459,132598,173720
2023-06-01,33124,-68,0,2678,5145,7755,1593,2,42144,137748,181487
2023-07-01,33124,-64,0,1840,5078,6854,1529,2,43977,142820,188328
2023-08-01,33124,-78,0,1534,9889,11345,1451,2,45511,152709,199673
2023-09-23,33124,-40,0,-545,8501,7916,1411,2,44966,161210,207589
2023-10-01,33124,-100,-1,-869,9547,8577,1311,1,44108,170763,216183
2023-11-01,33124,-36,0,-3251,10004,6717,1275,1,40848,180761,222885
2023-12-01,33124,-44,0,-2883,11733,8806,1231,1,37965,192494,231691
2022-01-01,33874,383,14,379,720,1496,2800,67,13021,6245,22133
2022-02-01,33874,123,10,762,725,1620,2923,77,13783,6970,23753
2022-03-01,33874,53,5,1200,792,2050,2976,82,14983,7762,25803
2022-04-01,33874,-153,4,-403,793,241,2824,86,14581,8554,26045
2022-05-01,33874,-116,12,346,1281,1523,2708,98,14927,9835,27568
2022-06-01,33874,-107,9,382,1155,1439,2601,107,15309,10990,29007
2022-07-01,33874,-102,-3,-79,1295,1111,2498,104,15230,12285,30117
2022-08-01,33874,-159,12,-185,1541,1209,2339,116,15045,13826,31326
2022-09-01,33874,-116,-8,166,1709,1751,2223,108,15211,15535,33077
2022-10-01,33874,-70,-3,89,1174,1190,2153,105,15300,16708,34266
2022-11-01,33874,-82,-3,-54,1177,1038,2071,102,15246,17885,35304
2022-12-01,33874,-1173,-5,-104,1983,701,898,97,15142,19868,36005
2023-01-01,33874,-25,-4,274,1425,1670,873,93,15416,21293,37675
2023-02-01,33874,-57,-4,-45,1615,1509,816,89,15371,22908,39184
2023-03-01,33874,-35,-5,-247,1721,1434,781,84,15124,24629,40618
2023-04-01,33874,-27,-2,-117,1525,1379,754,82,15007,26154,41997
2023-05-01,33874,-25,-2,-266,2131,1838,729,80,14741,28285,43835
2023-06-01,33874,-31,0,191,1943,2103,700,81,14951,30255,45987
2023-07-01,33874,-31,-1,-257,1395,1106,667,79,14672,31622,47040
2023-08-01,33874,-28,0,-21,1963,1914,639,79,14651,33585,48954
2023-09-23,33874,-13,1,26,1721,1735,626,80,14677,35306,50689
2023-10-01,33874,-364,-1,-341,770,64,264,80,14357,36113,50814
2023-11-01,33874,-37,-1,-449,1625,1138,227,78,13890,37700,51895
2023-12-01,33874,-6,-1,-414,1635,1214,221,77,13476,39335,53109
2022-01-01,35004,-14,1,996,443,1426,670,4,11947,5869,18490
2022-02-01,35004,-30,0,1274,-297,947,640,4,13221,5572,19437
2022-03-01,35004,-58,0,1575,813,2330,582,4,14796,6385,21767
2022-04-01,35004,-27,0,497,861,1331,555,4,15297,7250,23106
2022-05-01,35004,-11,0,676,1218,1883,544,4,15973,8468,24989
2022-06-01,35004,-15,0,346,1276,1607,529,4,16319,9744,26596
2022-07-01,35004,-4,-1,327,899,1221,525,3,16646,10643,27817
2022-08-01,35004,-9,0,134,1808,1933,516,3,16780,12451,29750
2022-09-01,35004,-11,0,435,2072,2496,505,3,17215,14523,32246
2022-10-01,35004,-10,0,660,1732,2382,495,3,17875,16255,34628
2022-11-01,35004,-9,0,232,1629,1852,486,3,18107,17884,36480
2022-12-01,35004,-6,0,243,2209,2446,480,3,18350,20093,38926
2023-01-01,35004,-10,0,584,2213,2787,470,3,18934,22302,41709
2023-02-01,35004,3,0,568,1599,2170,473,3,19503,23906,43885
2023-03-01,35004,-18,0,226,2574,2782,455,3,19729,26480,46667
2023-04-01,35004,-12,0,302,2090,2380,443,3,20031,28570,49047
2023-05-01,35004,-8,0,862,1812,2666,435,3,20892,30382,51712
2023-06-01,35004,-3,0,1368,2039,3404,432,3,22260,32421,55116
2023-07-01,35004,-5,0,775,1943,2713,427,3,23035,34364,57829
2023-08-01,35004,-3,0,136,2657,2790,424,3,23171,37021,60619
2023-09-23,35004,-1,0,440,1958,2397,423,3,23611,38979,63016
2023-10-01,35004,-12,0,1308,2277,3573,411,3,24919,41256,66589
2023-11-01,35004,-6,0,247,2440,2681,405,3,25166,43696,69270
2023-12-01,35004,-4,0,-954,2394,1436,401,3,24212,46090,70706
2022-01-01,35084,167,2,1130,1532,2831,1559,12,14776,13053,29400
2022-02-01,35084,40,0,1021,1632,2693,1599,12,15797,14685,32093
2022-03-01,35084,-16,2,1903,1608,3497,1583,14,17700,16293,35590
2022-04-01,35084,-66,0,436,1212,1582,1517,14,18136,17505,37172
2022-05-01,35084,-50,0,1092,845,1887,1467,14,19228,18350,39059
2022-06-01,35084,-57,1,1598,491,2033,1410,15,20826,18841,41092
2022-07-01,35084,-39,-1,1356,395,1711,1371,14,22182,19236,42803
2022-08-01,35084,-94,0,1059,1418,2383,1277,14,23241,20654,45186
2022-09-01,35084,-50,0,909,2020,2879,1227,14,24150,22674,48065
2022-10-01,35084,-30,1,416,1764,2151,1197,15,24566,24438,50216
2022-11-01,35084,-45,0,-874,1550,631,1152,15,23692,25988,50847
2022-12-01,35084,-537,0,-101,2572,1934,615,15,23591,28560,52781
2023-01-01,35084,-16,0,-65,2625,2544,599,15,23526,31182,55322
2023-02-01,35084,-19,-1,-14,2430,2396,580,14,23512,33614,57720
2023-03-01,35084,-26,0,-263,3271,2982,554,14,23249,36885,60702
2023-04-01,35084,-16,-1,-406,3456,3033,538,13,22843,40341,63735
2023-05-01,35084,-14,0,210,3676,3872,524,13,23053,44017,67607
2023-06-01,35084,-12,0,746,2451,3185,512,13,23799,46468,70792
2023-07-01,35084,-12,-2,636,2095,2717,500,11,24435,48563,73509
2023-08-01,35084,-17,-1,905,3089,3976,483,10,25340,51652,77485
2023-09-23,35084,-221,0,-695,447,-469,262,10,24645,52099,77016
2023-10-01,35084,-10,0,-272,2872,2590,252,10,24373,54972,79607
2023-11-01,35084,-10,1,-2223,4950,2718,242,11,22150,59921,82324
2023-12-01,35084,-5,0,-1633,5421,3783,237,11,20517,65342,86107
2022-01-01,35614,3367,5,14080,12277,29729,45204,155,241422,123194,409975
2022-02-01,35614,5050,0,9009,4576,18635,50254,155,250431,127770,428610
2022-03-01,35614,7760,-1,22309,13894,43962,58014,154,272740,141664,472572
2022-04-01,35614,5909,-3,12351,12362,30619,63923,151,285091,154026,503191
2022-05-01,35614,8078,-1,9866,19415,37358,72001,150,294957,173441,540549
2022-06-01,35614,7508,1,4984,17908,30401,79509,151,299940,191349,570949
2022-07-01,35614,9091,-5,-18721,9990,355,88600,146,281218,201339,571303
2022-08-01,35614,7950,-2,-6627,17103,18424,96550,144,274591,218442,589727
2022-09-01,35614,7801,-2,2597,20057,30453,104351,142,277188,238499,620180
2022-10-01,35614,5425,-2,2260,16135,23818,109776,140,279447,254634,643997
2022-11-01,35614,3576,-3,-2183,10867,12257,113352,137,277264,265501,656254
2022-12-01,35614,4728,-3,-5112,17393,17006,118080,134,272152,282894,673260
2023-01-01,35614,2072,-2,4824,16087,22981,120152,132,276976,298980,696240
2023-02-01,35614,4577,0,2567,16767,23911,124729,132,279543,315749,720153
2023-03-01,35614,4378,-5,203,26548,31124,129107,127,279746,342297,751277
2023-04-01,35614,3836,-1,-1305,27350,29880,132943,126,278441,369647,781157
2023-05-01,35614,3114,0,8765,27460,39339,136057,126,287205,397107,820495
2023-06-01,35614,4002,-1,15127,23589,42717,140630,128,303248,422289,866295
2023-07-01,35614,1390,-1,10646,23221,35256,141435,124,312922,443849,898330
2023-08-01,35614,3249,0,10983,28458,42690,144684,124,323905,472307,941020
2023-09-23,35614,3541,0,1846,18371,23758,148225,124,325751,490678,964778
2023-10-01,35614,1904,-1,4437,25553,31893,150733,126,331144,518159,1000162
2023-11-01,35614,45,-4,-12408,52993,40626,150190,119,317771,569336,1037416
2023-12-01,35614,-690,-2,-14898,51864,36274,149500,117,302873,621200,1073690
2022-01-01,36084,810,0,-122,2595,3283,5637,4,25514,15894,47049
2022-02-01,36084,426,-1,-17,1882,2290,6063,3,25497,17776,49339
2022-03-01,36084,120,0,561,3217,3898,6183,3,26058,20993,53237
2022-04-01,36084,-210,0,356,2903,3049,5973,3,26414,23896,56286
2022-05-01,36084,-193,0,-219,3331,2919,5780,3,26195,27227,59205
2022-06-01,36084,-182,0,-917,3344,2245,5598,3,25278,30571,61450
2022-07-01,36084,-154,0,-1798,3296,1344,5444,3,23479,33867,62793
2022-08-01,36084,-259,0,-2395,3578,924,5185,3,21084,37445,63717
2022-09-01,36084,-145,0,504,1639,1998,5040,3,21588,39084,65715
2022-10-01,36084,-122,0,549,931,1358,4918,3,22137,40015,67073
2022-11-01,36084,-158,0,-946,357,-747,4760,3,21191,40372,66326
2022-12-01,36084,-2742,-1,-202,912,-2033,2018,2,20989,41284,64293
2023-01-01,36084,-72,0,1433,1728,3089,1946,2,22422,43012,67382
2023-02-01,36084,-40,0,-249,2284,1995,1906,2,22173,45295,69376
2023-03-01,36084,-59,0,-74,3343,3210,1847,2,22099,48638,72586
2023-04-01,36084,-48,0,-3,3470,3419,1799,2,22096,52108,76005
2023-05-01,36084,-37,0,622,492,1077,1762,2,22718,52599,77081
2023-06-01,36084,-47,0,-158,3650,3445,1715,2,22560,56249,80526
2023-07-01,36084,-57,0,226,4450,4619,1658,2,22786,60699,85145
2023-08-01,36084,-41,0,1801,4894,6654,1617,2,24587,65593,91799
2023-09-23,36084,-43,0,560,3245,3762,1574,2,25147,68838,95561
2023-10-01,36084,-46,0,372,3729,4055,1528,2,25519,72567,99616
2023-11-01,36084,-45,0,-274,3944,3625,1483,2,25245,76511,103241
2023-12-01,36084,-962,0,-911,2847,974,521,2,24334,79358,104215
2022-01-01,37964,2107,-1,1318,1851,5275,14017,20,76392,21808,112237
2022-02-01,37964,598,0,4432,1936,6966,14615,20,80824,23744,119203
2022-03-01,37964,146,-2,8306,2546,10996,14761,18,89130,26290,130199
2022-04-01,37964,-971,-1,3276,2212,4516,13790,17,92406,28502,134715
2022-05-01,37964,-726,-1,3651,3642,6566,13064,16,96057,32144,141281
2022-06-01,37964,-724,-1,5038,3115,7428,12340,15,101095,35259,148709
2022-07-01,37964,-623,-3,-6893,5264,-2255,11717,12,94202,40523,146454
2022-08-01,37964,-899,-2,-4791,7854,2162,10818,10,89411,48377,148616
2022-09-01,37964,-552,0,-2186,7498,4760,10266,10,87225,55875,153376
2022-10-01,37964,-436,0,-1815,5229,2978,9830,10,85410,61104,156354
2022-11-01,37964,-444,0,-1475,4969,3050,9386,10,83935,66073,159404
2022-12-01,37964,-5667,0,-3790,6763,-2694,3719,10,80145,72836,156710
2023-01-01,37964,-173,0,-66,6824,6585,3546,10,80079,79660,163295
2023-02-01,37964,-140,0,-1741,6479,4598,3406,10,78338,86139,167893
2023-03-01,37964,-158,0,-2497,7230,4575,3248,10,75841,93369,172468
2023-04-01,37964,-133,0,-2266,6559,4160,3115,10,73575,99928,176628
2023-05-01,37964,-123,0,-1232,8395,7040,2992,10,72343,108323,183668
2023-06-01,37964,-122,-1,935,5950,6762,2870,9,73285,114276,190440
2023-07-01,37964,-111,0,-1611,5633,3911,2759,9,71669,119905,194342
2023-08-01,37964,-105,0,-527,7341,6709,2654,9,71142,127246,201051
2023-09-23,37964,-120,0,-1078,7583,6385,2534,9,70064,134829,207436
2023-10-01,37964,-1799,0,-1767,5494,1928,735,9,68301,140327,209372
2023-11-01,37964,-117,0,-3676,8513,4720,618,9,64622,148836,214085
2023-12-01,37964,-26,0,-3818,8592,4748,592,9,60804,157428,218833
2022-01-01,40484,81,1,120,315,517,748,3,1709,2528,4988
2022-02-01,40484,34,0,49,500,583,782,3,1758,3028,5571
2022-03-01,40484,27,0,160,372,559,809,3,1918,3400,6130
2022-04-01,40484,-36,0,26,313,303,773,3,1944,3713,6433
2022-05-01,40484,-22,0,-36,160,102,751,3,1908,3873,6535
2022-06-01,40484,-24,0,30,256,262,727,3,1938,4129,6797
2022-07-01,40484,-25,-1,73,364,411,702,2,2011,4493,7208
2022-08-01,40484,-41,0,53,378,390,661,2,2064,4871,7598
2022-09-01,40484,-29,0,144,354,469,632,2,2208,5225,8067
2022-10-01,40484,-19,0,-3,232,210,613,2,2205,5457,8277
2022-11-01,40484,-18,0,-22,152,112,595,2,2183,5609,8389
2022-12-01,40484,-320,0,0,287,-33,275,2,2183,5896,8356
2023-01-01,40484,-3,0,65,315,377,272,2,2248,6211,8733
2023-02-01,40484,-11,0,-19,280,250,261,2,2229,6491,8983
2023-03-01,40484,0,-1,-75,348,272,261,1,2154,6839,9255
2023-04-01,40484,-3,0,-39,312,270,258,1,2115,7151,9525
2023-05-01,40484,-6,0,16,491,501,252,1,2131,7642,10026
2023-06-01,40484,-7,0,-29,353,317,245,1,2102,7995,10343
2023-07-01,40484,-5,0,62,319,376,240,1,2164,8314,10719
2023-08-01,40484,-1,0,-12,312,299,239,1,2152,8626,11018
2023-09-23,40484,-126,0,-53,-248,-427,113,1,2099,8378,10591
2023-10-01,40484,-9,0,-40,432,383,104,1,2059,8810,10974
2023-11-01,40484,3,0,-148,431,286,107,1,1911,9241,11260
2023-12-01,40484,0,0,-93,303,210,107,1,1818,9544,11470
2022-01-01,41304,1409,0,502,1020,2931,14795,0,8568,10319,33682
2022-02-01,41304,1497,0,64,565,2126,16292,0,8632,10884,35808
2022-03-01,41304,1823,0,639,540,3002,18115,0,9271,11424,38810
2022-04-01,41304,1382,0,393,806,2581,19497,0,9664,12230,41391
2022-05-01,41304,2122,0,-145,886,2863,21619,0,9519,13116,44254
2022-06-01,41304,2336,0,-66,979,3249,23955,0,9453,14095,47503
2022-07-01,41304,2670,0,-252,1253,3671,26625,0,9201,15348,51174
2022-08-01,41304,2333,0,-760,698,2271,28958,0,8441,16046,53445
2022-09-01,41304,1902,0,374,43,2319,30860,0,8815,16089,55764
2022-10-01,41304,2141,0,569,889,3599,33001,0,9384,16978,59363
2022-11-01,41304,1698,0,570,905,3173,34699,0,9954,17883,62536
2022-12-01,41304,1726,0,749,1060,3535,36425,0,10703,18943,66071
2023-01-01,41304,1330,0,-925,-478,-73,37755,0,9778,18465,65998
2023-02-01,41304,747,0,-234,1212,1725,38502,0,9544,19677,67723
2023-03-01,41304,1403,0,-525,1198,2076,39905,0,9019,20875,69799
2023-04-01,41304,996,0,-341,1522,2177,40901,0,8678,22397,71976
2023-05-01,41304,890,0,-177,1779,2492,41791,0,8501,24176,74468
2023-06-01,41304,1261,1,299,1413,2974,43052,1,8800,25589,77442
2023-07-01,41304,625,0,245,1088,1958,43677,1,9045,26677,79400
2023-08-01,41304,1148,0,362,1421,2931,44825,1,9407,28098,82331
2023-09-23,41304,1444,0,179,1638,3261,46269,1,9586,29736,85592
2023-10-01,41304,955,-1,-11,1172,2115,47224,0,9575,30908,87707
2023-11-01,41304,836,0,-630,2045,2251,48060,0,8945,32953,89958
2023-12-01,41304,-913,0,-668,2475,894,47147,0,8277,35428,90852
2022-01-01,41884,502,0,-148,1502,1856,3551,6,12597,9772,25926
2022-02-01,41884,301,0,93,1047,1441,3852,6,12690,10819,27367
2022-03-01,41884,95,0,316,2012,2423,3947,6,13006,12831,29790
2022-04-01,41884,-108,0,213,1748,1853,3839,6,13219,14579,31643
2022-05-01,41884,-108,0,177,2275,2344,3731,6,13396,16854,33987
2022-06-01,41884,-66,0,-299,1638,1273,3665,6,13097,18492,35260
2022-07-01,41884,-76,-2,-719,2069,1272,3589,4,12377,20561,36531
2022-08-01,41884,-118,0,-984,2080,978,3471,4,11393,22641,37509
2022-09-01,41884,-77,0,188,1370,1481,3394,4,11581,24011,38990
2022-10-01,41884,-69,0,89,867,887,3325,4,11670,24878,39877
2022-11-01,41884,-83,0,-948,384,-647,3242,4,10722,25262,39230
2022-12-01,41884,-1595,0,-235,401,-1429,1647,4,10487,25663,37801
2023-01-01,41884,-33,0,985,1081,2033,1614,4,11472,26743,39833
2023-02-01,41884,-35,0,376,1088,1429,1579,4,11848,27831,41262
2023-03-01,41884,-41,0,462,1488,1909,1538,4,12310,29319,43171
2023-04-01,41884,-31,0,158,1845,1972,1507,4,12468,31164,45143
2023-05-01,41884,-28,0,719,206,897,1479,4,13187,31370,46040
2023-06-01,41884,-23,0,-143,1840,1674,1456,4,13047,33226,47733
2023-07-01,41884,-32,0,31,2306,2305,1424,4,13074,35512,50014
2023-08-01,41884,-35,0,975,2717,3657,1389,4,14049,38229,53671
2023-09-23,41884,-36,-1,311,1424,1698,1353,3,14360,39653,55369
2023-10-01,41884,-25,-1,389,1627,1990,1328,2,14752,41301,57383
2023-11-01,41884,-32,0,-202,2580,2346,1296,2,14548,43862,59708
2023-12-01,41884,-712,0,-893,1199,-406,584,2,13655,45061,59302
2022-01-01,42034,59,0,-17,129,171,456,0,822,1276,2554
2022-02-01,42034,42,0,8,-51,-1,498,0,830,1225,2553
2022-03-01,42034,19,0,68,236,323,517,0,898,1461,2876
2022-04-01,42034,-12,0,100,165,253,505,0,998,1626,3129
2022-05-01,42034,-19,0,89,216,286,486,0,1087,1842,3415
2022-06-01,42034,-13,0,-29,77,35,473,0,1058,1918,3449
2022-07-01,42034,-10,0,-126,108,-28,463,0,932,2026,3421
2022-08-01,42034,-15,0,-114,128,-1,448,0,818,2154,3420
2022-09-01,42034,-14,0,9,115,110,434,0,827,2269,3530
2022-10-01,42034,-4,0,1,173,170,430,0,828,2442,3700
2022-11-01,42034,-13,0,-48,66,5,417,0,780,2508,3705
2022-12-01,42034,-245,0,-3,108,-140,172,0,777,2616,3565
2023-01-01,42034,-2,0,82,117,197,170,0,859,2733,3762
2023-02-01,42034,-5,0,107,114,216,165,0,966,2847,3978
2023-03-01,42034,-1,0,-54,181,126,164,0,911,3028,4103
2023-04-01,42034,-1,0,-25,179,153,163,0,886,3207,4256
2023-05-01,42034,-7,0,16,49,58,156,0,902,3256,4314
2023-06-01,42034,-3,0,-36,144,105,153,0,866,3400,4419
2023-07-01,42034,-3,0,19,174,190,150,0,885,3574,4609
2023-08-01,42034,-6,0,5,217,216,144,0,890,3791,4825
2023-09-23,42034,-1,0,3,177,179,143,0,893,3968,5004
2023-10-01,42034,-4,0,36,142,174,139,0,929,4110,5178
2023-11-01,42034,-5,0,-52,162,105,134,0,877,4272,5283
2023-12-01,42034,-78,0,-53,82,-49,56,0,824,4354,5234
2022-01-01,42644,889,0,430,974,2293,7898,16,19249,11651,38814
2022-02-01,42644,617,0,897,539,2053,8515,16,20146,12190,40867
2022-03-01,42644,191,0,1448,1227,2866,8706,16,21594,13417,43733
2022-04-01,42644,-271,-1,-1097,1586,217,8435,15,20498,15004,43952
2022-05-01,42644,-282,0,144,1974,1836,8153,15,20642,16978,45788
2022-06-01,42644,-214,-1,73,1308,1166,7939,14,20715,18286,46954
2022-07-01,42644,-209,0,113,1614,1518,7730,14,20827,19900,48471
2022-08-01,42644,-380,0,207,1189,1016,7350,14,21034,21089,49487
2022-09-01,42644,-241,0,661,1625,2045,7109,14,21695,22714,51532
2022-10-01,42644,-284,0,555,1802,2073,6825,14,22250,24516,53605
2022-11-01,42644,-378,0,-283,1037,376,6447,14,21967,25553,53981
2022-12-01,42644,-3429,0,-564,2061,-1932,3018,14,21403,27614,52049
2023-01-01,42644,-166,0,202,2138,2174,2852,14,21605,29752,54223
2023-02-01,42644,-38,0,-157,2358,2163,2814,14,21448,32110,56386
2023-03-01,42644,-49,0,-291,3071,2731,2765,14,21157,35181,59117
2023-04-01,42644,-66,0,33,2118,2085,2699,14,21190,37299,61202
2023-05-01,42644,-61,0,-103,2150,1986,2638,14,21087,39449,63188
2023-06-01,42644,-62,0,-17,1706,1627,2576,14,21071,41155,64816
2023-07-01,42644,-39,0,200,1853,2014,2537,14,21270,43008,66829
2023-08-01,42644,-66,0,942,1855,2731,2471,14,22212,44863,69560
2023-09-23,42644,-77,0,1220,1320,2463,2394,14,23432,46183,72023
2023-10-01,42644,-1162,0,2018,546,1402,1232,14,25450,46729,73425
2023-11-01,42644,-120,-1,757,987,1623,1112,13,26207,47715,75047
2023-12-01,42644,-29,0,410,2367,2748,1083,13,26617,50082,77795
2022-01-01,45104,380,0,124,1203,1707,3137,8,11387,6569,21101
2022-02-01,45104,208,-1,634,883,1724,3345,7,12021,7452,22825
2022-03-01,45104,70,0,694,1023,1787,3415,7,12715,8475,24612
2022-04-01,45104,-157,0,-863,1066,46,3258,7,11852,9541,24658
2022-05-01,45104,-136,-1,270,1095,1228,3122,6,12122,10636,25886
2022-06-01,45104,-112,-1,102,877,866,3010,5,12224,11513,26752
2022-07-01,45104,-124,-3,-28,865,710,2886,2,12196,12378,27462
2022-08-01,45104,-181,0,-70,658,407,2705,2,12126,13036,27869
2022-09-01,45104,-104,-1,243,881,1019,2601,1,12369,13917,28888
2022-10-01,45104,-102,0,34,1069,1001,2499,1,12403,14986,29889
2022-11-01,45104,-105,0,-93,494,296,2394,1,12310,15480,30185
2022-12-01,45104,-1393,0,-243,862,-774,1001,1,12067,16342,29411
2023-01-01,45104,-31,0,145,1007,1121,970,1,12212,17349,30532
2023-02-01,45104,-47,0,24,1002,979,923,1,12236,18351,31511
2023-03-01,45104,-36,0,-19,1608,1553,887,1,12217,19959,33064
2023-04-01,45104,-40,0,44,1286,1290,847,1,12261,21245,34354
2023-05-01,45104,-39,0,-129,1392,1224,808,1,12132,22637,35578
2023-06-01,45104,-29,0,-78,1296,1189,779,1,12054,23933,36767
2023-07-01,45104,-24,0,133,807,916,755,1,12187,24739,37682
2023-08-01,45104,-35,0,190,1120,1275,720,1,12377,25859,38957
2023-09-23,45104,-26,0,100,968,1042,694,1,12477,26827,39999
2023-10-01,45104,-474,0,176,678,380,220,1,12653,27505,40379
2023-11-01,45104,-39,0,64,1238,1263,181,1,12717,28743,41642
2023-12-01,45104,-4,0,-331,1610,1275,177,1,12386,30353,42917
2022-01-01,45294,3069,0,1165,3998,8232,38454,5,25845,39391,103695
2022-02-01,45294,3376,-1,-155,1563,4783,41830,4,25690,40954,108478
2022-03-01,45294,4238,0,1406,3047,8691,46068,4,27096,44001,117169
2022-04-01,45294,3401,0,491,2728,6620,49469,4,27587,46729,123789
2022-05-01,45294,4603,0,-93,-550,3960,54072,4,27494,46179,127749
2022-06-01,45294,4150,0,-444,8,3714,58222,4,27049,46186,131461
2022-07-01,45294,5296,-1,-470,2715,7540,63518,3,26579,48901,139001
2022-08-01,45294,4432,0,-1455,1743,4720,67950,3,25124,50644,143721
2022-09-01,45294,3789,0,558,99,4446,71739,3,25682,50743,148167
2022-10-01,45294,3612,0,1935,2113,7660,75351,3,27617,52856,155827
2022-11-01,45294,3650,-1,1494,2993,8136,79001,2,29111,55849,163963
2022-12-01,45294,3576,0,1963,4333,9872,82577,2,31074,60182,173835
2023-01-01,45294,2630,0,-2931,-1819,-2120,85207,2,28143,58363,171715
2023-02-01,45294,1704,-2,-393,3357,4666,86911,0,27750,61720,176381
2023-03-01,45294,3109,0,-1642,3657,5124,90020,0,26108,65377,181505
2023-04-01,45294,2177,0,-1010,5381,6548,92197,0,25098,70758,188053
2023-05-01,45294,1732,0,336,7015,9083,93929,0,25434,77773,197136
2023-06-01,45294,2717,0,1087,5626,9430,96646,0,26522,83419,206587
2023-07-01,45294,1205,0,579,5135,6919,97851,0,27099,88532,213482
2023-08-01,45294,2123,0,228,6085,8436,99974,0,27327,94617,221918
2023-09-23,45294,3014,0,256,5812,9082,102988,0,27583,100429,231000
2023-10-01,45294,1825,0,-220,4955,6560,104813,0,27368,105412,237593
2023-11-01,45294,1881,0,-2008,7246,7119,106694,0,25355,112630,244679
2023-12-01,45294,-2128,0,-1747,8140,4265,104566,0,23608,120770,248944
2022-01-01,47664,872,1,1235,1818,3926,7261,6,28162,18808,54237
2022-02-01,47664,506,0,2267,2192,4965,7767,6,30429,21000,59202
2022-03-01,47664,429,0,2924,2595,5948,8196,6,33353,23595,65150
2022-04-01,47664,47,0,-301,2239,1985,8243,6,33053,25834,67136
2022-05-01,47664,246,0,399,3316,3961,8489,6,33452,29150,71097
2022-06-01,47664,366,0,-6,2705,3065,8855,6,33446,31855,74162
2022-07-01,47664,492,-3,79,2305,2873,9347,3,33525,34160,77035
2022-08-01,47664,324,0,-199,2429,2554,9671,3,33326,36589,79589
2022-09-01,47664,314,0,1101,2899,4314,9985,3,34427,39488,83903
2022-10-01,47664,282,0,519,3003,3804,10267,3,34946,42491,87707
2022-11-01,47664,267,0,197,2984,3448,10534,3,35143,45475,91155
2022-12-01,47664,-1440,0,-381,3579,1758,9094,3,34762,49054,92913
2023-01-01,47664,347,0,719,3150,4216,9441,3,35481,52204,97129
2023-02-01,47664,425,0,214,2786,3425,9866,3,35695,54990,100554
2023-03-01,47664,395,-1,68,4397,4859,10261,2,35763,59387,105413
2023-04-01,47664,340,0,-6,4657,4991,10601,2,35756,64044,110403
2023-05-01,47664,383,-2,532,5163,6076,10984,0,36288,69207,116479
2023-06-01,47664,312,0,289,4387,4988,11297,0,36577,73597,121471
2023-07-01,47664,253,0,859,4156,5268,11549,0,37436,77750,126735
2023-08-01,47664,354,0,576,5769,6699,11903,0,38012,83519,133434
2023-09-23,47664,-329,0,102,6698,6471,11574,0,38114,90217,139905
2023-10-01,47664,41,0,167,9873,10081,11615,0,38281,100094,149990
2023-11-01,47664,-117,0,-1892,10262,8253,11498,0,36389,110351,158238
2023-12-01,47664,-114,0,-2297,19678,17267,11384,0,34092,130029,175505
2022-01-01,47764,493,0,229,728,1450,3139,2,15350,5270,23761
2022-02-01,47764,187,0,224,38,449,3326,2,15574,5308,24210
2022-03-01,47764,130,0,665,783,1578,3456,2,16239,6091,25788
2022-04-01,47764,-148,0,-315,709,246,3308,2,15925,6800,26035
2022-05-01,47764,-106,0,326,771,991,3202,2,16251,7571,27026
2022-06-01,47764,-95,0,-535,472,-158,3107,2,15716,8043,26868
2022-07-01,47764,-118,0,-439,561,4,2989,2,15277,8604,26872
2022-08-01,47764,-170,0,-593,813,50,2819,2,14684,9417,26922
2022-09-01,47764,-99,0,387,801,1089,2720,2,15071,10218,28011
2022-10-01,47764,-109,0,72,1262,1225,2611,2,15143,11480,29236
2022-11-01,47764,-146,0,-40,673,487,2465,2,15103,12153,29723
2022-12-01,47764,-1491,0,-446,1561,-376,974,2,14657,13714,29347
2023-01-01,47764,-31,0,152,1273,1394,943,2,14809,14987,30741
2023-02-01,47764,-52,0,84,1095,1127,891,2,14893,16082,31868
2023-03-01,47764,-29,0,-152,1409,1228,862,2,14741,17491,33096
2023-04-01,47764,-33,0,-198,1297,1066,829,2,14543,18788,34162
2023-05-01,47764,-42,0,119,2813,2890,787,2,14662,21601,37052
2023-06-01,47764,-37,0,532,1908,2403,750,2,15196,23510,39458
2023-07-01,47764,-29,0,501,1637,2109,721,2,15696,25146,41565
2023-08-01,47764,-42,0,529,1563,2050,679,2,16225,26709,43615
2023-09-23,47764,-495,0,55,1051,611,184,2,16280,27760,44226
2023-10-01,47764,-20,0,-104,1698,1574,164,2,16177,29460,45803
2023-11-01,47764,-1,0,-957,1598,640,163,2,15219,31056,46440
2023-12-01,47764,-2,0,-999,1597,596,161,2,14220,32653,47036
2022-01-01,48424,392,0,433,1697,2522,3134,3,7924,12978,24039
2022-02-01,48424,142,-1,-11,1174,1304,3276,2,7913,14152,25343
2022-03-01,48424,33,0,391,2367,2791,3309,2,8304,16519,28134
2022-04-01,48424,-166,0,104,1720,1658,3143,2,8408,18239,29792
2022-05-01,48424,-129,0,-170,1681,1382,3014,2,8238,19920,31174
2022-06-01,48424,-116,-1,-568,1418,733,2898,1,7670,21338,31907
2022-07-01,48424,-114,0,-41,821,666,2784,1,7629,22159,32573
2022-08-01,48424,-202,0,-486,1444,756,2582,1,7143,23603,33329
2022-09-01,48424,-115,0,210,1317,1412,2467,1,7353,24920,34741
2022-10-01,48424,-84,0,435,2120,2471,2383,1,7788,27040,37212
2022-11-01,48424,-114,0,298,2159,2343,2269,1,8086,29199,39555
2022-12-01,48424,-93,0,743,1663,2313,2176,1,8829,30862,41868
2023-01-01,48424,-106,0,-359,-850,-1315,2070,1,8470,30012,40553
2023-02-01,48424,-69,0,145,1160,1236,2001,1,8615,31172,41789
2023-03-01,48424,-1166,0,-345,1728,217,835,1,8270,32900,42006
2023-04-01,48424,-40,0,-149,2762,2573,795,1,8121,35662,44579
2023-05-01,48424,-47,0,-185,2762,2530,748,1,7936,38424,47109
2023-06-01,48424,-23,0,5,2746,2728,725,1,7941,41170,49837
2023-07-01,48424,-29,0,9,2662,2642,696,1,7950,43832,52479
2023-08-01,48424,-40,0,-28,4417,4349,656,1,7922,48249,56828
2023-09-23,48424,-30,0,-57,4002,3915,626,1,7865,52251,60743
2023-10-01,48424,-48,0,-351,3824,3425,578,1,7514,56075,64168
2023-11-01,48424,-14,0,-412,4339,3913,564,1,7102,60414,68081
2023-12-01,48424,-13,0,-526,4706,4167,551,1,6576,65120,72248
2022-01-01,48864,397,1,334,809,1541,2705,8,7271,7185,17169
2022-02-01,48864,86,0,486,677,1249,2791,8,7757,7862,18418
2022-03-01,48864,28,0,1019,687,1734,2819,8,8776,8549,20152
2022-04-01,48864,-142,0,562,556,976,2677,8,9339,9105,21129
2022-05-01,48864,-110,-1,690,367,946,2567,7,10029,9472,22075
2022-06-01,48864,-94,-1,143,814,862,2473,6,10172,10286,22937
2022-07-01,48864,-91,-2,-250,729,386,2382,4,9922,11015,23323
2022-08-01,48864,-145,-1,-255,647,246,2237,3,9667,11662,23569
2022-09-01,48864,-113,-1,345,913,1144,2124,2,10012,12575,24713
2022-10-01,48864,-103,0,245,1215,1357,2021,2,10257,13790,26070
2022-11-01,48864,-102,0,-146,637,389,1919,2,10111,14427,26459
2022-12-01,48864,-1177,0,40,933,-204,742,2,10151,15360,26255
2023-01-01,48864,-22,0,115,1081,1174,720,2,10266,16441,27429
2023-02-01,48864,-21,-1,-156,1311,1133,699,1,10109,17752,28561
2023-03-01,48864,-39,0,-296,1380,1045,660,1,9813,19132,29606
2023-04-01,48864,-23,0,-258,1070,789,637,1,9555,20202,30395
2023-05-01,48864,-27,0,-111,1922,1784,610,1,9444,22124,32179
2023-06-01,48864,-31,0,138,2174,2281,579,1,9582,24298,34460
2023-07-01,48864,-20,0,73,1819,1872,559,1,9655,26117,36332
2023-08-01,48864,-35,0,33,1571,1569,524,1,9688,27688,37901
2023-09-23,48864,-365,0,-253,413,-205,159,1,9435,28101,37696
2023-10-01,48864,-32,0,-212,1278,1034,127,1,9223,29379,38730
2023-11-01,48864,-10,0,-584,1613,1019,117,1,8639,30992,39749
2023-12-01,48864,-1,0,-514,1305,790,116,1,8125,32297,40539
2022-01-01,99999,135521,148,130438,204829,470936,1742292,6661,3415149,2170356,7334458
2022-02-01,99999,152172,85,157610,108101,417968,1894464,6746,3572759,2278457,7752426
2022-03-01,99999,154159,-1,231471,259536,645165,2048622,6745,3804164,2537975,8397506
2022-04-01,99999,119170,-42,-68993,215259,265394,2167770,6642,3734667,2752990,8662069
2022-05-01,99999,155914,77,25762,227682,409435,2323684,6719,3760429,2980672,9071504
2022-06-01,99999,163344,1,5319,264413,433077,2487028,6720,3765720,3245055,9504523
2022-07-01,99999,192500,-815,-109557,238028,320156,2679527,5904,3656105,3483031,9824567
2022-08-01,99999,161711,-17,-79348,257633,339979,2841238,5887,3576757,3740665,10164547
2022-09-01,99999,158226,-104,42099,239167,439388,2999464,5783,3618836,3979799,10603882
2022-10-01,99999,120947,-62,85778,244623,451286,3120370,5721,3703037,4224270,11053398
2022-11-01,99999,106789,-61,38850,184044,329622,3226837,5659,3740520,4407912,11380928
2022-12-01,99999,38401,-98,19214,259838,317355,3265570,5562,3761061,4668156,11700349
2023-01-01,99999,65391,-50,33343,249994,348678,3330959,5512,3794369,4918081,12048921
2023-02-01,99999,134716,-106,15047,270428,420085,3465676,5406,3809448,5188630,12469160
2023-03-01,99999,132538,-98,-41825,365839,456454,3598213,5308,3767607,5554452,12925580
2023-04-01,99999,123952,-40,-48893,405029,480048,3722164,5268,3718703,5959475,13405610
2023-05-01,99999,137470,-78,-14627,391461,514226,3859630,5190,3704064,6350921,13919805
2023-06-01,99999,155121,-75,14962,394424,564432,4020024,5172,3727941,6762741,14515878
2023-07-01,99999,106703,-39,10366,345215,462245,4121189,5074,3729485,7089835,14945583
2023-08-01,99999,128253,-71,51530,403695,583407,4249442,5003,3781003,7493515,15528963
2023-09-23,99999,113496,33,-21924,267980,359585,4362938,5036,3759079,7761495,15888548
2023-10-01,99999,59053,-76,-44869,287852,301960,4428222,5018,3722882,8069053,16225175
2023-11-01,99999,35774,-44,-116980,427453,346203,4457737,4919,3598867,8476599,16538122
2023-12-01,99999,-7222,-10,-138023,424091,278836,4450515,4909,3460844,8900690,16816958
